2222222222
00vv00vv00
00vv01vv00
0002222200
1001000010